1111111111111111111111100011111110221111111420111111111001111111300111111330011111111111111111111111
1111111111104000000110000200111001101011100100101110010010111001011001110030000111111111111111111111
1111111111111111111111111111111110311111140020001110230020111111311111111111111111111111111111111111
1111111111111111111111100011111110221111111013311111102301111110040111111111111111111111111111111111
1111111111111111111111111111111100000111112111001113030020111400100011111111111111111111111111111111
1111111111111111111111111111111110011111100000011111001220111140300311111111111111111111111111111111
1111111111110040001110000000111001110011110011001111020130111100002011111311111111111111111111111111
1111111111111111111111111111111100111111100320001110131210111000000411111111111111111111111111111111
1111111111111111111111111111111100000111100111011110002020111000133411111111111111111111111111111111
1111111111111111111111100111111110004111111101011111312100111132001011113000201111111111111111111111
1111111111111111111111000001111131103111110402011111001201111100100111111111111111111111111111111111
1111111111111111111111100001111113112011110234001111001000111100001111111111111111111111111111111111
1111111111111111111111111001111110204111111020011111300101111130000111111111111111111111111111111111
1111111111111111111111143001111100000111110010211111001203111111101011111110001111111111111111111111
1111111111111111111111111111111100001111110202111111033420111111130011111111111111111111111111111111
1111111111111111111111110001111100230111114032301111110120111111000111111111111111111111111111111111
1111111111111111111111110031111102010111110020011111031401111100001111111111111111111111111111111111
1111111111111111111111111104111113110011110330201111021200111100001111111111111111111111111111111111
1111111111111111111111000111111100330111110011211111100100111112000411111001111111111111111111111111
1111111111111111111111100001111103032111110024001111111010111111100011111111111111111111111111111111
